..........
.###......
.#S#......
.###......
..........
..........
....###...
....#E#...
....###...
..........