#E..........##.....##..#.
#.#...##.##..###....###.#
#.#.#........##..#.####.#
#.#.##..#..#.###..#..##..
#.#.###..#.#..##....#...#
#.#.##.#...#..#..##.##...
..#.#..##.##.##.##..#..##
..#.#.###.##..S.##.###.##
.............##.##....#..
..######.##.#......##...#
#...........#..###..#...#
#..########.#.#....#..#.#
##.#######..#....#.......
##...#.....#####.#..#####
##.#######.##...###.#####
##.#######.#....#...##...
#.....###..###..###.####.
....#####.#....#......##.
.#####....#########...##.
........#.....###....##..
..##.##.###.#.###...##..#
#..#..........#...#####.#
##.###.#.########.####..#
##.###.#.##.......#.....#
.......#.#..#####...#.#..