#S.............#.....#####..#..#.#########.....##
#.##.#.#.##.##.###....#..###....##.#...#...#...##
#..#.#.#..#..#.#...###.#.#.#####..##.#.#.#.#.#.##
##.#.#.##.##.#.#.##..#.###.#####.#..##...#..#.#.#
#..#...#..##...#..##.#..#.#..##..#.####..###.#..#
##.#####.###.###.##.##.###..##.###...###.###.#.##
#......#.##...#.....#..###....#.###..#.#..#.##..#
#.######.#.##.###.##.#.##..###.#..##..###..##.###
##.##....##....#..###..##..##.###.#####.#...###.#
#.###.##.##.####..##..##..##.####....###.#...##.#
#.....##.#....##..#...###.#...###.#..##.#..####.#
##.###.#.#.#..###.#..#######..###.###..#..##..###
#.#.#..##..##..#.#..#.##..###..###..#.####..###.#
#.##.#####.###.#.###..###..#.#..#.#...###.###.##.
#..#.#.....##.#.##..###.###.#.####...#....##..##.
###.##.#.#####.#..#.#...##..#....###..##.###.###.
#.##..#......##..###.#.##..###.##..####.#....##.#
##..###..##.##.#.####.##..#.#...##.#...###.###.#.
#.#.#.###......#.##..#.#.#.#.###.####.#..##.#..#.
#.#.#.#.#..#.##.#..#.#.#..###.#...##.#.#.#.#..#.#
#.#.#.#.##.#.#..###.#.###.##.##.###..#.##..#.#..#
#.###.#...#..##..##.#..#...###.#..##..####.#.#.##
#....##..##..#..#.#...####..##.#..#..###..###.#..
#.###.###.#.#####.#####..##.#.###..##..####.###..
#.####.#.....####....##.#..###.#.#.###.#...##.#.#
#.....#.#..#....#..###.#..##..#.##.#.#.##...##.##
#..#..##..##...#..##..#.#....#.#....#.##.##.#.#..
#..#.###.####..##.#.#.##.#.##...##.#..#....#.#..#
#.#.###.#..#.#.#.#..##.#.#..##.#..##...#.##.#.##.
#...##.#..##.#...##.##.###...###.###.#.#.##..#..#
#.#####.##..#..##.#...##.#.###.##..#...##.##..###
#.#...#..##...#...##..###.#..#....##.###.#.#.##..
#.#.#.#.#.###..##.#..##...#.#...####.#...##...##.
#.#.#..###.##.#..#.##..###.#..#.#..#.##..###.#.#.
#.#.#####..#...###.#####.#...##..#.#...#...#.#.#.
#...#...###.#.##.#...##..###..###.###..##..#...#.
#.#...#..##.#.#.#.#...##.#..#...#.#.###.#..##.##.
#.#.#.#.#####.#.#.###.###.#.#..#...#.###.#.#..###
#.#...##..###.#..#.##.#..#...#.####.#.#..#.#.#..#
#.#.#.##.###..##.###..#.#..###..#.#.#.#.##.#.###.
#.#.#.#.##.##....#.##..#.##.##.#.#.##.#..##.#...#
#.#.#...#.#...##.###.#..##.#..#...#..#..#.##..#.#
#.#.###.#.#..##.#.#...#...##.#..##..#...##..#.#..
#.#.#...#.#...###.#.#..###..#.#.#...##.#.#...#.#.
#.#.#.###.#...#.#.##...##.#.#.#.#..##..#.###.#.#.
#.#...#.#....#...##..###.#.#...##..#.#.#...###.#.
#.#.#.#.#.##.#..###.###..#.#.###.#...#.#.#...#.##
#.#.#.#...#...#..#..#.#.##.#.#.#.###.###..###.#.#
#.#.#..###.#.E.###..#.#.#..##.#...#.#...#.##...#.