...........
.#####.....
.#...#.....
.#.S.#.....
.#...#.....
.#####.....
...........
....#####..
....#...#..
....#.E.#..
....#...#..
....#####..
...........