##...........##.........E...#....##...........####
##.#####..##....#.#.####.##...##.##.#########.....
##.......###.####.#......###.#.#....##.#......###.
..###.##.#..###.###.#.#.#...#...#######..###.##.#.
#.##..##...##.......##.####..##.##....#.##.#.#.#..
#....#####...##..##.#...#.##.##....##.#.####.####.
#####....##..###..###.#...##.####.#...#...........
.....###.##...###.....##.###....#.#.###.#####.####
######.#.###.#####..###.###..##.##......#####...##
...##................###....#.#....####...#.###...
#####.#######.#.####..##.####.######..##...##.###.
##....#######.#.....#..#.####....#########..###...
#..##..###....#..##.##.....##.##.###.....##....#.#
#.####.###.##.####.###.###....##.#.#.###.#.##.####
#...##.....##..........#.#######.###.#...#.##.####
.##..#####.#####.#####.#.##.#.#####..#.##..##....#
..##.#####.#####.#####..............##..########.#
#.###........##........############.#.#.....#..#..
#.######.###....##.###.##....###....#.#####.#.###.
.......#.###.####..##..##.#...##.####...##..####..
.#########...##.###...##.####.##..###.#####......#
.###..#....###.#....####.####.###...#.#...######.#
..#..##..##....#.#.#.#.......#####..#.#.#......#.#
#.#.###.###.##.#.###...#.#########..#.#..####..#..
##....#..###...#....####....#######.#.##...###.##.
##.#####.###.######.#..####.####....#.####.###..##
##..####..#....####.##..##..###..#####..##.####.#.
###.#####...##.###..#.##...###..#.....#....####.#.
###...#...##.#.###.#.##..##....##.####.#.##.#...#.
#####.#####..#.#...##...###.#####....#...#..#.###.
...##.#.#...##...####.#####....#####..###..##..##.
.#..#.#.#.##############.##.##...####..#######.##.
.##.#.#.#............###.##.#.##...###.#.#.......#
.#..#.##.###########.###....#..###.....#.#.##.##.#
.#.##.##.##......###.###.####.##########.#.#.#.#.#
##.##.##.##.####.###.###.#....#.......#..#.##....#
##.##....##..###.###.....######.#####.####....###.
##...#######..##.....###........#...#.....####....
#.##.###..###.##########.######.#####.###.###..###
.....####.#.#...#.....##.##..##.......###...##....
######......###.#.###..#.#....##.##########..####.
....##.#.######.#...##.#.####.##.##......###..##..
.##...#####...#.###.###......#...#.####.####.####.
.####...###.#...###.#.##.###...##.#.#..#......##.#
.######.....#######.#..#.###.###.##.##...#####..##
.....####.####...##.##.#####.#.#..#...####....#.##
..##...###..#######...##.....##.#.###...##.##.#...
.##..#...####...##..#....#####.##.#####....##.###.
.##.####......#......###.#...#...#...########.#.#.
.........#####.##..#...#S..#...#...#..........#...