#E...........##
#.##.####.##.##
#.##.####.##.##
#.##.####.##.##
..............#
.####.##.##.#..
..###.##....##.
#.#...##.##.##.
....####.##.##.
#.#.###.....##.
..#..#..####.#.
#.###..##..#.#.
#.#...#.##...#.
#.#S#......#...
#...###.#######